M
20
1
// Level 0
j|a...............>.
.|||<<<<<<<<<<|||..t
>>>>............|..|
.|...t..........|t.|
.|...t..........|..|
.|...t..........|.t|
.|...t..........|.t|
.|.....t........|..|
.<<<<...t.......|.t|
.|.......t......|.t|
.|........t.....|..|
.|.........t....|t.|
.|..........t...|t.|
.|...........t..|..|
.|............t.|.t|
.|...........t..|..|
.|..........t...|t.|
.|........t.....|..|
.||||||||...|||||..|
...................|
